###########  ##
#..*#     # #  #
# # ##### #  ##
# # #     #
# # ##### #
#      #  #
######   ##
     #####
 ##
#@.#
